111111111111111
1C1X0010000X001
1001010P0100011
110101000011101
1E0000C0X000111
111111111111111
