111111111111111111
1C00000C00001C0001
100000000000000001
1101110001111C0001
1E0000000111100001
1111101100111P0001
1C0000000000100001
1000000C0000000001
110111000111100001
111111111111111111
